办公室->office
屋内->home
温度->air.temperature
湿度->air.humidity
亮度->light.brightness
二氧化碳浓度->co2.ppm
关灯->light.loff
开灯->light.lon
关闭空气净化器->purifier.poff
打开空气净化器->purifier.pon
关闭加湿器->humidifier.hoff
打开加湿器->humidifier.hon
保持空气湿润->humidifier.hon
关电扇->fan.foff
开电扇->fan.fon
启动扫地机器人->vacuum.von
停止扫地机器人->vacuum.voff
打扫卫生->vacuum.von
允许监视室内->allow monitoring the room
禁止监视室内->forbid monitoring the room
亮一点->light.brightness+
暗一点->light.brightness-
热一点->air.temperature+
冷一点->air.temperature-
温度高一点->air.temperature+
温度低一点->air.temperature-
二氧化碳浓度需要降低->co2.ppm-
湿度需要增加->air.humidity+
天黑->light.brightness<50
灯打开->light.lon
灯关闭->light.loff
门打开->door.open=1
门关闭->door.open=0
有人->person.in=1
没人->person.in=0
窗户打开->window.wopen
窗户关闭->window.wclosed
